11111111111111111111111
1000C000000000000000001
10000000000000000000001
1000000E0000000U0000001
1000000000000P000000001
10000000000000000000001
10000000000000000000001
11111111111111111111111
