111111111
10000C001
1000P0001
1000E0001
111111111
