1111111111111
1000001010001
1C00010010001
1E00100P00001
1111111111111
0000000000000
1000000000001
1111111111111
