1111111111111
1000001C10001
1C00000010001
1000000P00001
1111011111111
1C000000000C1
1111111111101
10000E0000001
1111111111111
