1111111111111
1C000C00C0001
1E000C00P0001
1111111111111
