1111111111111
1C00000000001
1E000000P0001
1111111111111
