1111111111111
1000001010001
1E00000000001
1111111111111
