1111111111111
1C00001C10001
100E0000P0001
1111111111111