1111111111111
1CC0001C10001
1000CP0000001
1000C11111111
1C000000000C1
1110001111101
1E00000000001
1111111111111
